Name	title	coding
t3_jyc5wq	Bo Erickson of CBS asks Biden about his son. He says it's just a smear campaign.	
t3_jxocbx	[Not Satire] National Democratic Party official suggests re-education for Trump supporters: 'How do you deprogram 75 million people?'	
t3_jy6x6f	Whatever Happens In The Next Few Weeks, Brothers and Sisters, Remember This Clip, My Favorite 60 seconds of Trump: 'I am your voice'	
t3_jymbgb	BLM Co-Founder Calls on Biden to Back a Crazy Progressive 'Civil Rights' Bill	
t3_jy16dv	New Senate Report Confirms Hunter Biden's Biz ties to CCP, Raises Troubling Ties to Kremlin	
t3_jy44lw	Trump Leads Voyage Of Pilgrims To Greenland To Establish Even Better America	
t3_jy6h4r	Romney on Trump election tactics: 'Difficult to imagine a worse, more undemocratic action' by president	
t3_jy0pv9	Chris Evans and Zach Braff Encourage Keeping Track of Trump ‘Enablers’	
t3_jy47z9	Biden Mocks a Reporter for Asking a Question as Biden's Staff Tries to Get the Press Out of There	
t3_jy0m21	Donald Trump returns to the White House briefing room claiming he 'won' and suggests Pfizer held back vaccine to sabotage his election and says without him the drug would have taken four YEARS	
t3_jy1crk	Trump Touts New Rules to 'End Global Free Loading' of Prescription Drugs	
t3_jy17l6	"Kayleigh McEnany Obliterates Both Dems, Media for Hypocrisy Over Election Results, Completely Levels CNN Reporter: ""Where were the calls for unity and a peaceful transition when President Trump was elected in 2016?"""	
t3_jxod6m	'No national shutdown': Joe Biden says shutting down the virus will not require a national lockdown	
t3_jxnh2b	Lawyer working on Trump Pennsylvania effort placed under official protection due to threats	
t3_jy0vje	Trump's daughter-in-law Lara reported to be considering 2022 Senate run	
t3_jy0aqe	BLM Co-founder: Biden's election was 'won by Black people', 'We want something for our vote.'	
t3_jxochk	New Senate report purportedly 'confirms' Biden family's business ties to Chinese, Russian governments	
t3_jxrzlp	Obama Tells Jimmy Kimmel: 'We Can Always Send the Navy SEALS' to Remove Trump from White House	
t3_jxzw8k	Donald Trump: ‘Big Pharma’ Purposely Delayed Coronavirus Vaccine Until After Election	
t3_jy2rb5	Trump lifts travel ban on Chad	
t3_jxsfmb	Whoa: Nearly a Third of Democrats Believe the Election Was Stolen From Trump	
t3_jxrnvy	Tucker Carlson​ says Trump attorney Sidney Powell wouldn't provide him with any evidence of election fraud. Powell hits back.	
t3_jxxtr7	Trump lawyers cited Minnesota counties in affidavit about Michigan: report	
t3_jxuonz	Elected DNC Member Floats Re-Education Camps for Trump Supporters	
t3_jxx2eu	Nancy Pelosi calls Trump a 'Psychopathic Nut'	
t3_jy0dkc	Donald Trump Jr. tests positive for COVID-19	
t3_jy0f6f	Donald Trump Jr tests positive for coronavirus	
t3_jxsv1q	Trump Campaign Fact-Checks the Media: Georgia Has Not Certified Biden's Win	
t3_jy1cs3	Bigot: Joe Biden Lackey Wanted to Destroy Amy Coney Barrett Because She's Catholic	
t3_jy1cr9	Gregg Jarrett Has an Important Reminder for the Media About the Trump Campaign's Evidence of Voter Fraud	
t3_jy3xhk	Catholics sounding alarm about Biden administration, conflicts with moral teachings	
t3_jy0ud9	‘Enormously insulting’: Sanders warns Biden not to shut out progressives	
t3_jxtmra	'We are a nation of laws, not tweets': Republican Sens. Romney and Sasse decry Trump efforts to challenge election	
t3_jxtoaq	Georgia certifies election results, making Biden win official	
t3_jxvx68	Biden stuggles with words at press conference -- 'I'm going to ... employ the defense, reconstruct the act'	
t3_jxny9j	Trump Legal Adviser Jenna Ellis Rips Media: ‘You Are Not Unbiased Jurors’	
t3_jym704	Obama Appointed Federal Judge Dismisses Trump Campaign Lawsuit in Pennsylvania	
t3_jxxelw	Trump Appears To Doubting Tucker And Lets Him Touch The Fraudulent Ballots Himself	
t3_jxsxuq	National Democratic Party official suggests re-education for Trump supporters: 'How do you deprogram 75 million people?'	
t3_jy0cbd	Opinion | Georgia Certifies: Donald Trump Lost	
t3_jxz4ek	Biden to Impose $200 Gun Tax | Americans for Tax Reform	
t3_jxo83f	Hunter Biden had deep business ties with communist party-linked Chinese tycoon: new Senate report	
t3_jxq1j3	Joe Biden stays silent over proposed meeting with BLM founder	
t3_jxvhyz	Lin Wood: President Trump won 400 electoral votes | One America News Network	
t3_jxuoli	Biden certified Georgia winner after hand recount	
t3_jy0r0u	Obamas producing Netflix anti-Trump comedy show	
t3_jxtalp	Intimidation Tactics Against Trump Lawyers Undermine Justice	
t3_jxxjgh	Giuliani, other Trump lawyers to skip meeting with Michigan lawmakers after COVID-19 exposure	
t3_jxow0s	Satire: Obama: 'Biden Has Touched Us All'	
t3_jxnwph	Catholic Bishop: 'I Beg Mr. Biden to Repent of His Dissent From Catholic Teaching on Abortion &amp; Marriage'	
t3_jxtkh6	Georgia Secretary of State Certifies Biden’s Win After Audit	
t3_jxgzoc	Trump campaign statement on Georgia	
t3_jy9cvg	U.S. Corporations with 'Made in China' Goods 'Optimistic' About Joe Biden	
t3_jz3tl3	Michael J. Fox says Donald Trump has played on 'every worst instinct in mankind': 'Biff is president!'	
t3_jz0akg	Trump, GOP’s ridiculous, flailing coup isn’t a joke. It’s a crime. There must be consequences | Will Bunch	
t3_jyzr2m	A Republican judge just tore into Trump’s election lawyers for their incompetence. Trump’s lawyers asked a judge to disenfranchise nearly 7 million voters. It ended badly for Trump.	
t3_jz44h2	Bernie Sanders says GOP ‘has ceased to be a political party’ and is now a ‘cult’ in fiery rebuke of Trump fraud claims	
t3_jz1z65	‘Stop golfing and concede’: Trump and Maryland Gov. Hogan spar again after president criticizes South Korean tests	
t3_jz5bfz	Trump campaign says Sidney Powell isn't a member of its legal team	
t3_jz0b6y	Claim that Trump 'was never given an orderly transition of power' is false	
t3_jz227v	GOP Senator Has Instructed Staff to Cooperate With Biden Transition, Says It's 'Past Time' for Trump to Do Same	
t3_jyy98l	Stacey Abrams helped register 800,000 voters and flipped Georgia for Biden. Here's what anyone can learn from her ability to inspire and influence others.	
t3_jz4z41	No, You Do Not Have to Feel the Trump Voter's Pain | There is no reason, after five and half years of untruths, dog-whistles, slurs and conspiracies, and weeks of Trump trying to undermine Biden’s win, to hug the people who want to disenfranchise you	
t3_jyxn1c	"Chris Christie: Trump's legal challenges against election results have been ""a national embarrassment"""	
t3_jz5qcv	Brian Stelter Slams Lara Trump For Declaring Trump Voters Don’t ‘Feel’ That He Lost - “Facts do not care about your feelings,” the CNN host said.	
t3_jz0yry	"GOP Governor On Trump's Election Tantrum: Beginning To Look Like A 'Banana Republic' - ""Frankly, I'm embarrassed that more people in the party aren’t speaking up,"" Maryland Gov. Larry Hogan said."	
t3_jywaur	3 ‘dead’ Georgia voters in fact very much alive: Trump, Tucker Carlson get it wrong	
t3_jz2pba	Small but growing number of Republicans tell Trump it’s over: “Stop golfing and concede”	
t3_jywjti	40% of Top Pentagon Positions Empty After Donald Trump's Firing of Mark Esper	
t3_jyxqd1	Chris Christie: Trump's legal team 'a national embarrassment'	
t3_jyyf6p	'Unacceptable': Wisconsin Election Officials Say Trump Observers Hindering Recount With Constant Interruptions, Questions	
t3_jz0eog	In Public, Trump Still Claims He Won. In Private, Aides Say He’s Planning for Life After Presidency.	
t3_jz1bxs	Biden reaches out. The GOP slaps him in the face.	
t3_jyxn3r	Hogan 'embarrassed that more people' in the GOP 'aren't speaking up' against Trump	
t3_jyvrie	Trump's embarrassing, incompetent, humiliating, very sad coup	
t3_jz6vh9	"Murkowski tells Trump: ""It is time to begin the full and formal transition process"""	
t3_jz67og	Trump Yet to Answer One Press Question Since Election As GOP Pressure for His Concession to Biden Grows	
t3_jywxtu	Michigan GOP Congressman Tells Trump 'It's Over': 'The Voters Spoke'	
t3_jyunps	Trump, laden with $400 million debts, plans to cash in on his post-presidency with a book deal, media appearances, and selling rally tickets, according to a report	
t3_jyvoq1	Young voters set turnout record, aiding Biden win	
t3_jyuup3	Trump Wonders Why Joe Biden Is Forming A Cabinet In Latest Tweet Screed	
t3_jz6gek	Trump campaign cuts Sidney Powell from president’s legal team - The abrupt shake-up comes as Powell makes far-fetched and unsupported claims of voter fraud in the 2020 elections.	
t3_jyys5f	Republican Gov. Larry Hogan is 'embarrassed that more people in the party aren't speaking up' against Trump's refusal to concede	
t3_jyyaoi	Trump Requests Georgia Recount, Meaning 5 Million Votes Will Be Tabulated A 3rd Time	
t3_jz3fxh	Claim that Trump 'was never given an orderly transition of power' is false	
t3_jywgwe	Republican senator congratulates Biden telling Trump to ‘accept outcome of election’	
t3_jyxw7j	Biden inauguration will be ‘scaled down’ because of coronavirus, chief of staff says	
t3_jyxlr4	Analysis: Donald Trump has left the world stage. Few will miss him	
t3_jz7cgh	"Trump dumps Sydney Powell, lawyer who promised to ""blow up"" Georgia, as legal strategy unravels"	
t3_jz1nzm	National Review Slams Trump’s Refusal To Concede As ‘A Bid For Infamy’ — The conservative magazine condemned the baseless lawsuits and conspiracies of the Trump legal team as a “profoundly undemocratic gambit.”	
t3_jz4ivr	Nearly all Pa. counties expect to sign off on election results by Monday despite Trump’s attempts to delay certification	
t3_jz1pj8	Mao’s Lesson for Trump’s America | Beware of leaders willing to set their own country on fire.	
t3_jywmds	Split-screen: Biden preps to be president, Trump fights for the job he is ignoring	
t3_jz61e3	Former Ohio Gov. John Kasich Says GOP Is 'Afraid' Of Trump	
t3_jyx75d	House Democratic Caucus chairman: Trump's presidency was a 'scam'	
t3_jyyeac	Chris Christie Tears Into Trump's Legal Team: 'A National Embarrassment'	
t3_jyvt2z	Wisconsin officials: Trump observers obstructing recount | Election officials overseeing the recount of presidential votes in Wisconsin’s largest county are accusing observers for President Donald Trump of unduly slowing the process	
t3_jz4v45	Longtime diplomat says Trump conspiracies hurt U.S. more than Russia, China	
t3_jyvp5p	Federal judge rejects Trump campaign's Pa. lawsuit with prejudice, saying it lacks factual proof	
t3_jyy2z6	Bolton calls on GOP leadership to label Trump's behavior 'inexcusable'	
t3_jz0nbc	Pressure grows from GOP for Trump to recognize Biden election win	
t3_jyrsd4	America is being subjected to a stress test – and Republicans are failing | Most elected Republicans are refusing to stand up to Trump. Their cowardice is one of the worst betrayals of public trust in the history of our republic	
t3_jyzf5a	Hogan: Trump making US look like a 'banana republic'	
t3_jz6p3p	‘Stop Golfing And Concede’ | Gov. Larry Hogan Hits Back At President Trump’s Tweet On South Korea COVID-19 Tests	
t3_jz6si6	Sidney Powell: Trump legal team disavows lawyer who claimed Venezuelan communists helped rig US election	
t3_jz3i4z	"""Stop golfing and concede"": Maryland GOP Governor Larry Hogan spars with Trump"	
t3_jyw4pb	Trump’s legal team cried vote fraud, but courts found none	
t3_jyy5hi	Trump, the Saboteur. First a Tantrum, Then Taking Every Opportunity to Trash Our Government	
t3_jz5jzx	Trump campaign says Sidney Powell not a member of legal team	
t3_jz0mhl	Trump’s wildest claims are going nowhere in court. Thank legal ethics. Thank legal ethics. The president’s lawyers can’t make assertions without evidence in front of judges.	
t3_jz3iys	"Small but growing number of Republicans tell Trump it's over: ""Stop golfing and concede"""	
t3_jz6lhi	Threats to Election Officials Piled Up as President Trump Refused to Concede	
t3_jyqowe	Michiganders Erupt After Their Maskless Lawmakers Sip Dom Perignon At Trump Hotel - Michigan legislators celebrate together after secretive meeting with Trump, who has been plotting to overturn the state’s vote for Joe Biden.	
t3_jz6fej	Trump campaign attempts to distance from conspiracy-theorist lawyer Sidney Powell	
t3_jz7lhm	Edward Norton tears into 'whiny, sulky, petulant, Grinchy, vindictive' Donald Trump in pointed, poker-laced Twitter thread	
t3_jz22oq	Hogan ramps up criticism of Trump: 'Stop golfing and concede'	
t3_jyzx62	Trump faces pressure from Republicans to drop 'corrosive' fight to overturn election	
t3_jz73xa	Judge Dismisses Trump Campaign's Bid To Delay Vote Certification In Pennsylvania	
t3_jz32ir	Larry Hogan to Trump: 'Stop golfing and concede' the election 'If you had done your job, America's governors wouldn't have been forced to fend for themselve,' Hogan said	
t3_jypw7q	Out of 53 Republican senators, only two have stood up to Trump's attempt to overturn the election	
t3_jz404d	Team Trump offering 'fire hose' of conspiracy Kool-Aid for supporters	
t3_jz52gp	'Stop golfing and concede': Gov. Hogan fires back on Pres. Trump's COVID test claims	
t3_jyyvlv	Twitter Recognizes Biden as the Next @POTUS, Despite Trump's Denial	
t3_jz0mm7	Bolton: 'Trump is throwing rocks through windows'	
t3_jyw2mu	Trump threatens to wreak havoc on the GOP from beyond the White House	
t3_jz3dde	Trump is in an unprecedented streak of silence	
t3_jz44bn	The Two Biggest Losers: Trump and Giuliani — The bigoted New York septuagenarians team up for one last hurrah.	
t3_jys1yc	Trump’s tyranny is the moral equivalent of treason	
t3_jz54v1	"Fifth GOP Senator congratulates Biden and Harris, says Trump has ""exhausted all"" Penn. legal options"	
t3_jyqcfr	After Pennsylvania court defeat, Trump faces new pressure to concede election	
t3_jz6cus	Trump campaign purges conspiracy-theorist Sidney Powell from legal team	
t3_jyvv5t	Trump team requests another recount of Georgia’s presidential race, a day after results certified in Joe Biden’s victory	
t3_jz2hti	Biden opens the door to protecting the Arctic Refuge	
t3_jz739w	Wisconsin Trump Campaign Lawyer Trying to Throw Out His Own Vote	
t3_jysd13	Ben Carson Confirms Trump’s Friends Get Better Coronavirus Treatments	
t3_jz2pci	Tapper: Judges are running out of pejoratives for Trump's legal efforts - CNN Video	
t3_jyx06u	Election Updates: Trump Campaign Faces Major Legal Setbacks; Biden Wins Certified	
t3_jz6unm	Lisa Murkowski calls on Trump to end court fights	
t3_jz5yna	Trump Campaign Disavows Its Own Election-Conspiracy Lawyer	
t3_jz45sv	More key Republicans tell Trump to end delays. ‘Past time to start a transition’	
t3_jz265e	Trump’s legal team cried vote fraud, but courts found none	
t3_jz5a2y	Republicans quietly plot to sink Biden nominees	
t3_jz1a2t	Trump Lawyer Sidney Powell Says Georgia Election Lawsuit 'Will Be Biblical,' Suggests GOP Governor Helped Biden	
t3_jyx8pe	Biden aide says GSA holdup prevents background checks on cabinet picks	
t3_jz55kh	Biden Team, Pushing Quick Stimulus Deal, Prepares for Renewed Recession	
t3_jz5oyu	Trump campaign says Sidney Powell not a member of legal team	
t3_jz557f	Pat Toomey: Trump Campaign Has Exhausted Legal Options and Biden Won	
t3_jyobrs	On Parler, a pro-Trump call for Georgia runoff boycott threatens Mitch McConnell's plan to restrain Biden	
t3_jz0fch	Senators push to stop Trump administration’s proposed arms sale to UAE	
t3_jz4wcx	Young voters in the US turned out in record numbers in 2020, powering Biden's presidential victory	
t3_jz828i	Yet another Georgia election official receives threats after state certifies Biden win	
t3_jyoleb	Kayleigh McEnany said Trump wasn't given an 'orderly transition of power' in 2016. He was.	
t3_jyxte1	Trump’s Legal Team Cried Voter Fraud, But Courts Found None	
t3_jyxl4z	Trump ally, former NJ governor Chris Christie: president’s election fraud claims are a ‘national embarrassment’	
t3_jyzag6	Chris Christie Calls Trump Legal Team ‘National Embarrassment,' Tells President to End Election Suits	
t3_jz5ofk	Giuliani distances Trump campaign from attorney Sidney Powell	
t3_jyt5rw	Liz Cheney says Trump should respect ‘sanctity’ of election if he can’t prove claims in court	
t3_jz0vxg	Christie calls Trump's legal efforts a 'national embarrassment' as more Republicans speak out	
t3_jz72fx	Murkowski calls on Trump to begin transition process, decries 'pressure campaign on state legislators'	
t3_jz7o2y	Giuliani releases statement distancing Trump campaign from lawyer Sidney Powell	
t3_jz3pdw	Wisconsin officials: Trump observers obstructing recount	
t3_jz614o	Trump legal team disavows association with lawyer Sidney Powell	
t3_jyzjg9	Congresswoman Liz Cheney is the latest Republican calling on Trump to prove fraud claims in court	
t3_jymtbq	Megathread: Judge Dismisses Trump Lawsuit Seeking to Delay Certification in Pennsylvania	
t3_jz2mz3	Trump Campaign Didn’t Request a Recount in Wisconsin Counties Using Dominion Machines	
t3_jz8bvm	Native American voters across Minnesota turned out to oust Trump - Vote totals were up around Red Lake, and 90% for Biden	
t3_jz42uk	Trump’s legal team cried vote fraud, but courts found none	
t3_jz2555	In last-gasp maneuver, Trump campaign tries to invalidate thousands of votes as Wisconsin recount gets underway	
t3_jyufn4	Trump’s quest to overturn election runs into quiet resistance from local and state Republicans	
t3_jyzjov	Chris Christie dismissed Trump's legal team as 'a national embarrassment'	
t3_jyoi1n	"""Trump has exhausted all plausible legal options"": GOP Sen. Pat Toomey congratulates Biden"	
t3_jyno88	Pa. Senator Pat Toomey Says President Trump Has ‘Exhausted All Plausible Legal Options’	
t3_jz7po7	Biden to Name Longtime Aide Blinken as Secretary of State	
t3_jz2dpu	Chris Christie calls the conduct of Trump’s legal team a ‘national embarrassment’	
t3_jz2ofa	Miami Republicans won’t criticize baseless Trump claims of Venezuelan election rigging	
t3_jyx846	Sen. Toomey Congratulates Biden After Pennsylvania Judge Dismisses Trump Lawsuit	
t3_jz7ynb	More Republicans Tiptoe Toward Acknowledging Biden’s Victory	
t3_jynvr3	Detroit voters sue President Trump over his attempt to block certification of election results	
t3_jz1k5h	Trump team making false argument about his 2016 transition	
t3_jz1j0x	Chris Christie: Trump’s Legal Team Has Been a ‘National Embarrassment’	
t3_jyrnq8	States and Local Republicans standing up to Trump are putting National GOP leaders to shame	
t3_jz7x4k	Trump campaign parts ways with Powell after vote-switching claim	
t3_jz5lhv	Attorney Heading Up Trump Campaign's Wisconsin Recount Effort is Seeking to Throw Out His Own Vote	
t3_jyxajt	After Pennsylvania legal defeat, Trump digs in despite new pressure to concede election	
t3_jz7ko0	Incoming chief of staff says Biden will begin announcing top Cabinet picks this week	
t3_jz088i	Trump team making false argument about his 2016 transition	
t3_jz3wcq	President-elect Joe Biden will announce cabinet picks Tuesday	
t3_jyljff	Joy Reid: It looks like Republicans 'want to hand Biden mega crises' and a country that's broken	
t3_jz81tt	Trump lashes out at fellow Republicans as his legal challenges to election results fail	
t3_jyxodl	U.S. courts find no voter fraud despite cries from Trump’s legal team	
t3_jz3ygy	Refusing to concede, Trump pushes for another recount in Georgia	
t3_jytj5f	Trump or No Trump, Religious Authoritarianism Is Here to Stay	
t3_jz8gig	Man seen exhaling on women outside Trump golf club charged	
t3_jz3bwt	Against Returning to Normal | Joe Biden positioned himself as the “return to normalcy” candidate. But normalcy is not something we can afford—we must actively resist it.	
t3_jyjecp	Wisconsin officials: Trump observers obstructing recount	
t3_jyz8b3	For U.S. election officials certifying results, Trump's refusal to concede has chilling consequences	
t3_jyuofr	Judge rules against Trump global media chief after firings | A federal judge has ruled against the head of the agency that runs the Voice of America and other U.S.-funded news outlets who was accused of trying to turn it into a propaganda vehicle to promote President Donald Trump’s agenda	
t3_jz5d4v	A Few More Hill GOPers Push Trump To Accept Reality As More Legal Battles Fall Flat	
t3_jyzx05	Latino Democrats tell Mexican president to get with the program and back Biden	
t3_jyzfzs	Chris Christie Says Trump's Legal Team Has Become a 'National Embarrassment'	
t3_jz1j6s	Missing links: Trump goes golfing in middle of G20 summit	
t3_jz7kyq	Democrats expect Biden to name Linda Thomas-Greenfield UN ambassador	
t3_jz5ffr	Trump campaign says Sidney Powell not a member of legal team	
t3_jyj5z6	Detroit voters sue Donald Trump over unsubstantiated claims of voter fraud	
t3_jyxu4b	Biden advisor: 'He does not have any concern' about Trump lawsuits	
t3_jyy8fq	Biden to name first Cabinet picks Tuesday, as Trump bemoans swift actions	
t3_jyy5dt	Facebook, Instagram Will Switch White House Accounts From Trump to Biden on Jan. 20	
t3_jymfwh	Wisconsin election officials say Trump observers obstructing recount, some ‘clearly don’t know what they are doing’	
t3_jyvps6	Judge's devastating question for team Trump	
t3_jyk8mk	‘My Frustration Turned Into Anger.’ Some Americans Who Lost Family Members to COVID-19 Have Turned Against Donald Trump	
t3_jyyy5l	Biden inauguration will be scaled down amid COVID, aide says	
t3_jyn1nu	'Absolutely shameful': Schiff condemns Trump's golf outing	
t3_jz003m	Chris Christie calls Trump's legal team a 'national embarrassment'	
t3_jz0elw	President-elect Joe Biden to announce Cabinet picks Tuesday	
t3_jyi4xi	Impeach the president again — Removal from office wouldn’t be the goal this time. It would be to prevent Trump from running again.	
t3_jyhv9o	Trump was pictured on his Virginia golf course during a coronavirus meeting for G20 leaders	
t3_jz071b	‘National Embarrassment’: Christie Blasts Trump’s Legal Team As Election Challenges Fizzle	
t3_jz2hjq	Trump team making false argument about his 2016 transition	
t3_jyxvfq	Biden chief of staff says inauguration ‘not going to be the same’	
t3_jz7cd3	Trump’s campaign vows to appeal Pennsylvania lawsuit all the way to Supreme Court	
t3_jz65om	Barack Obama on a Biden presidency, racism in the Trump era and what he misses about being president	
t3_jz5qol	Biden Plans to Move Fast With a ‘Climate Administration.’ Here’s How.	
t3_jyy0a9	Trump election challenges sound alarm among voters of color	
t3_jyvhg1	Biden hits Trump for refusing to concede, says 'national mask mandate' discussed with govs	
t3_jz68im	Why a federal judge threw out Trump's Pennsylvania election lawsuit	
t3_jyih12	Yes, Trump Is (Still) Engaged in an Attempted Coup; and Yes, It Might Lead to a Constitutional Crisis and a Breaking Point	
t3_jz7vxc	Biden to unveil first Cabinet picks on Tuesday, envisions scaled-down inauguration	
t3_jz6dv5	Women set to take key roles in Biden administration	
t3_jywlx5	Biden's first Cabinet picks coming Tuesday, chief of staff Klain says	
t3_jyo5jb	Pa. Sen. Toomey congratulates President-elect Joe Biden, calls on Trump to begin transition	
t3_jz0b53	Trump tells G-20 world leaders that Paris climate accord was 'designed to kill the American economy'	
t3_jz2622	Trump’s overarching Middle East strategy reaches a disastrous dead end	
t3_jz0az8	Pennsylvania GOP Sen. Toomey Says Trump Should Accept Election Loss	
t3_jz3cid	Can Republicans Get Trump-Style Turnout Without Trump on the Ballot?	
t3_jz055a	Rep. Jeffries: Trump is in a massive meltdown right now	
t3_jyjnr1	Trump Campaign Lawyers File New Pennsylvania Motion Which Misspells Governor’s Name	
t3_jz3tv7	Ronna McDaniel has reportedly warned Donald Trump Jr., Kimberly Guilfoyle could succeed her as RNC chair	
t3_jz3bgw	Louis: Biden transition news is now the top priority	
t3_jymexa	RNC Backs Trump's Bogus Claims That He Won the Election	
t3_jyrw5r	Why President-elect Joe Biden should cancel the inaugural balls during COVID	
t3_jz2ux2	#Resist was a success, in looking back at Trump's presidency	
t3_jyp99g	Biden Says Containing Pandemic Is Vital to Economic Recovery	
t3_jz7wz1	Biden to Name Longtime Aide Blinken as Secretary of State	
t3_jz8dam	Biden Chooses Antony Blinken, Defender of Global Alliances, as Secretary of State	
t3_jz81lx	Biden plans to name Blinken secretary of state: Bloomberg	
t3_jz3r4j	Trump appeals rejection of effort to block Pennsylvania vote	
t3_jyufz5	‘Something very historical’: Native Americans push for diverse Biden Cabinet	
t3_jyomso	GOP senator congratulates Biden, says Trump should accept results	
t3_jyg71f	NAACP Federal Suit: Trump Violated Voting Rights Act	
t3_jyzg9r	Rudy Giuliani says election case losses help Trump campaign’s strategy to get ‘expeditiously’ to Supreme Court	
t3_jz2d5u	Ronna McDaniel has reportedly warned Donald Trump Jr., Kimberly Guilfoyle could succeed her as RNC chair	
t3_jyp41a	Wisconsin election officials say Trump observers are obstructing the recount and interrupting vote counters	
t3_jyfn88	Trump tweets about election results and skips session on pandemic during G20	
t3_jz38b8	In Wisconsin recount, Trump challenges pile up, slow tally	
t3_jyn72v	"""Joe Biden Way"" sign unveiled in Scranton"	
t3_jyevov	Trump Supporters in Georgia Threaten to Destroy GOP, Boycott Runoff Elections	
t3_jz3we3	The ‘last voice in the room.’ What will Kamala Harris do as Joe Biden’s vice president?	
t3_jyu2fl	The federal toll of Trump's failure to lead	
t3_jz1lvu	Trump seeks expedited appeal of Pennsylvania ruling against effort to toss mail-in ballots	
t3_jyjcxb	Wisconsin officials: Trump observers obstructing recount	
t3_jz5hlr	Chris Christie rips Trump's legal team as ‘national embarrassment’	
t3_jyym78	Biden will announce first Cabinet picks on Tuesday, chief of staff Klain says	
t3_jyebbg	GOP asks Michigan not to certify election results, citing ‘irregularities’ | The move follows speculation that Trump is seeking to persuade Michigan Republicans to override election results	
t3_jz866v	Get Me Meacham! Biden Brings Back the Media’s Good Old Days	
t3_jyv7ng	Spy Jonathan Pollard expected to fly to Israel after US lifts parole. Release marks latest gesture by departing Trump administration towards the Israeli government	
t3_jyoq50	Trump calls on GOP state legislatures to overturn election results	
t3_jz8l93	Top Biden adviser seen as making tech regulation more likely	
t3_jz7uqg	Joe Biden’s first Cabinet picks expected Tuesday amid Trump's road blocks to transition	
t3_jz5rv6	Trump campaign says Sidney Powell not a member of legal team	
t3_jz2tha	Trump obsession: Democrats tweet about him 12,569 times to 486 about Biden	
t3_jyzq16	Putin Says He’s Not Ready to Recognize Biden as U.S. President	
t3_jyzpvt	"How Trump Responded When Liz Cheney Called on Him to Concede: ""Sorry Liz, can’t accept the results of an election with hundreds of thousands of fraudulent votes cast, enough to easily flip the Election. You’re just unhappy that I’m bringing the troops back home where they belong!"""	
t3_jz63x3	Trump campaign says Sidney Powell isn't a member of its legal team	
t3_jz7p9d	In Apparent Glitch, Voting Machines Hunt Down And Murder Trump Supporters	
t3_jyvpw5	BREAKING: FDA Grants Emergency Use Authorization To Antibody Cocktail Used By Trump	
t3_jyxl1z	How to explain Latino support for Trump? ABC News reports misleading memes went viral in Latino communities	
t3_jyymh1	Reap What You Sow: Media Who Coddled Biden for Months Now Complain About Mistreatment	
t3_jz7frn	Trump Campaign Formally Requests a Recount in Georgia	
t3_jz5fzn	Federal judge dismisses Trump campaign’s Pennsylvania case	
t3_jz6olk	Sidney Powell No Longer Part of Trump's Legal Team: Giuliani Statement	
t3_jywg7k	Devout Catholic Joe Biden, our most pro-abortion president	
t3_jz5h7b	Young voters set turnout record, aiding Biden	
t3_jyz99e	Trump Lawyer Sidney Powell Promises 'Biblical' Lawsuit in Coming Days	
t3_jz37gc	Trump Derangement Syndrome in Democrats won't go away with Trump	
t3_jz447i	"Omar Urges Biden To Reverse Trump's Agreements In The Middle East And Claims They Were ""Not Peace Deals"""	
t3_jylbj0	CNN Condemns Trump Rallies As 'Physically Peaceful But Morally Violent'	
t3_jyunuj	"Trump campaign adviser Steve Cortes: Sudden Stop In Mail-In Vote Count 'Suspicious' -- Particularly since it was followed by a ""deluge"" of votes for Joe Biden in key battleground states."	
t3_jywdz5	Philly Bans All Indoor Gatherings Unless You're Still Counting Biden Votes	
t3_jz5f71	Julie Burchill: President Trump has loved and been great for Israel	
t3_jyulqn	Trump Team Files for Fresh Recount in Georgia’s Presidential Race	
t3_jz60sj	Dominion responds to Trump team claims	
t3_jz56nz	GOP senator says Trump to Biden transition should begin 'tomorrow morning'	
t3_jyjte3	Ilhan Omar Urges Biden to ‘Reverse’ President Trump’s Middle East Agreements -- Thinks that peace between Israel and Arab nations is a bad thing.	
t3_jz3j9r	BLM Founders Demand Joe Biden Support A 'Roadmap' To Abolition Of Police, Prisons	
t3_jyxyyy	China Issues Instructions for ‘Incoming Biden Administration’	
t3_jyl85p	Judge Dismisses Trump Campaign Suit to Invalidate PA Election Certification With Prejudice	
t3_jz6rre	"Joseph Nye: ""Trump deserves credit for pushing back on China's abusive trade practices, but it would have been better if we worked with our allies to isolate China. Also, his trade deal has been costly for Americans without changing the trade imbalance or addressing technological issues."""	
t3_jyqh97	Chinese Warn Against Communism at Trump Rally, Tell Americans to Speak Out	
t3_jylfat	Hispanic Voters In Florida Who Fled Dictatorships Think The Election Was Stolen From Trump	
t3_jz3bhq	Pennsylvania election: Trump appeals dismissal of bid to block vote certification	
t3_jz7fr3	Latest: Why a Federal Judge Tossed Out One of the Trump Campaign's PA Lawsuits	
t3_jyztx6	Do Trump Supporters Live in an Alternate Universe?	
t3_jyp5q9	Actor Scott Baio threatens to move to Utah to unseat Sen. Mitt Romney after his anti-Trump tweet	
t3_jym9cn	Pennsylvania Judge Dismisses Trump Campaign's Challenge to Pennsylvania Election Law	
t3_jyusgt	Ben Carson: Trump Saved My Life After I Got COVID	
t3_jykyw7	Federal Election Commission Chair: Trump Campaign Has Legitimate Claims of Election Fraud	
t3_jz421o	It begins: The Biden border surge, and too bad about the COVID lockdowns	
t3_jynp3x	Trump Orders Hasty Afghanistan, Iraq Drawdowns to Beat Biden Inauguration	
t3_jyuhux	Trump campaign attorney responds to Pennsylvania ruling &amp; they’re grateful	
t3_jymov0	Trump Warns 'Massive Fraud' to Be Uncovered in Michigan Vote	
t3_jz1z44	Top House conservative plots post-Trump GOP	
t3_jygwhl	Donald Trump Improved Standing With Latinos In 78 Of America’s 100 Majority-Hispanic Counties	
t3_jypb2u	Philly Bans All Indoor Gatherings Unless You're Still Counting Biden Votes	
t3_jysta7	Trump camp's lawsuit struck down in Pennsylvania	
t3_jytpjk	Pa. Senator Pat Toomey Says President Trump Has 'Exhausted All Plausible Legal Options'	
t3_jyp7pw	Judge Dismisses Trump Campaign’s Pennsylvania Lawsuit, Slams ‘Strained’ Reasoning; This only helps these cases reach higher levels of court because signed affidavits are admissible in court	
t3_jz1up7	Trump Lawyer Says New Lawsuits Will Be Filed in Georgia Soon: 'Quite a Shock'	
t3_jyby0o	Trump Announces Groundbreaking Rules to Lower Prescription Drug Prices	
t3_jyr204	Trump campaign files for new recount in Georgia	
t3_jynua5	Release: Toomey Statement on PA Federal Court Decision, Congratulates President-elect Biden | U.S. Senator Pat Toomey of Pennsylvania	
t3_jyoy6m	Biden to ‘Racist’ Trump Voters: ‘Let’s Heal.’ That’s Easy for Him to Say.	
t3_jypjqa	Merkel's Germany Tells Trump Not to Bring Troops Home from Afghanistan	
